WWWWWWWWWWW
WCCCCCCCCCW
WCWWWCWWWCW
WCWWWCWWWCW
WCCCCCCCCCW
WWWWWWWWWWW
